               BBBBB BBBBB        BBBBB          B
 BBBBBBBBBBBBB BBBBB BBBBB BBBBBB BBBBB BBBBBBBB B
 BBBBBBBBBBBBB BBBBB BBBBB BBBBBB BBBBB BBBBBBBB B
 BBBBBBBBBBBBB BBBBB BBBBBLBBBBBB BBBBB BBBBBBBB B
         BBBBBSBBBBB BBBBBBBBBBBB       BBBBBBBB B
 BBBBBBB BBBBBBBBBBB BBBBBBBBBBBB BBBBB BBBBBBBB B
 BBBBBBB BBBBBBBBBBB BBBBBBBBBBBB BBBBB BBBBBBBB B
 BBBBBBB BBBBBBBBBBB BBBB         BBBBB BBBBBBBB B
 BBBBBBB             BBBB BBBBBBBBBBBBB BBBBBBBB B
 BBBBBBBBBBBBBBBBBBB BBBB BBBBBBBBBBBBB          B
 BBBBBBBBBBBBBBBBBBB BBBB BBBBBBBBBBBBB BBBBBBBBBB
 BBBBBBBBBBBBBBBBBBB BBBB BBBBBBBBBBBBB BBBBBBBBBB
               BBBBB              BBBBB BBBBBBBBBB
BBBBBBBBBBBBBB BBBBBBBBBBBBBBBBBB BBBBB BBBBBBPBBB
BBBBBBBBBBBBBB BBBBBBBBBBBBBBBBBB BBBBB BBBBBB BBB
BBBBBBBBBBBBBB BBBBBBBBBBBBBBBBBB BBBBB BBBBBB BBB
LBBBBBBBBBBBBB          BBBBBBBBBBBBBBB BBBBBB BBB
 BBBBBBBBBBBBB BBBBBBBB BBBBBBBBBBBBBBB BBBBBB BBB
               BBBBBBBB BBBBBBBBBBBBBBB BBBBBB BBB
BBBBBBBBBBBBBBBBBBBBBBB                        BBB
