PBBBBBB       BBBBB        BBB
 BBBBBBBBBBBB BBBBB BBBBBB BBB
 BBBBBBBBBBBB BBBBB BBBBBB BBB
 BBBBBBBBBBBB BBBBB BBBBBB BBB
 BBBBBBBBBBBB       BBBBBB BBB
 BBBBBBBBBBBB BBBBB BBBBBB BBB
 BBBBBBBBBBBB BBBBB BBBBBB BBB
 BBBB         BBBBB BBBBBB BBB
 BBBB BBBBBBBBBBBBB BBBBBB BBB
 BBBB BBBBBBBBBBBBB        BBB
 BBBB BBBBBBBBBBBBB BBBBBBBBBB
 BBBB BBBBBBBBBBBBB BBBBBBBBBB
              BBBBB BBBBBBBBBB
BBBBBBBBBBBBBBBBBBB BBBBBBBBBB
BBB     LBBBBBBBBBB BBBBBBBBBB
BBB BBBBBBBBBBBBBBB BBBBBBBBBB
BBB BBBBBBBBBBBBBBB BBBBBBBBBB
BBB                 BBBBBBBBBB
BBB BBBBBBBBBBBBBBBBBBBBBBBBBB
BBBBBBBBBBBBBBBBBBBBBBBBBBBBBB
