               BBBBB BBBBB        BBBBB          B
 BBBBBBBBBBBBB BBBBB BBBBB BBBBBB BBBBB BBBBBBBB B
 BBBBBBBBBBBBB BBBBB BBBBB BBBBBB BBBBB BBBBBBBB B
 BBBBBBBBBBBBB BBBBB BBBBBLBBBBBB BBBBB BBBBBBBB B
         BBBBBSBBBBB BBBBBBBBBBBB       BBBBBBBB B
BBBBBBBB BBBBBBBBBBB BBBBBBBBBBBB BBBBB BBBBBBBB B
BBBBBBBB BBBBBBBBBBB BBBBBBBBBBBB BBBBB BBBBBBBB B
BBBBBBBB BBBBBBBBBBB BBBB         BBBBB BBBBBBBB B
LBBBBBBB             BBBB BBBBBBBBBBBBB BBBBBBBB B
 BBBBBBBBBBBBBBBBBBB BBBB BBBBBBBBBBBBB          B
 BBBBBBBBBBBBBBBBBBB BBBB BBBBBBBBBBBBB BBBBBBBBBB
 BBBBBBBBBBBBBBBBBBB BBBB BBBBBBBBBBBBB BBBBBBBBBB
               BBBBB              BBBBB BBBBBBBBBB
BBBBBBBBBBBBBB BBBBBBBBBBBBBBBBBB BBBBB BBBBBBBBPB
BBBBBBBBBBBBBB BBBBBBBBBBBBBBBBBB BBBBB BBBBBBBB B
BBBBBBBBBBBBBB BBBBBBBBBBBBBBBBBB BBBBB BBBBBBBB B
LBBBBBBBBBBBBB          BBBBBBBBBBBBBBB BBBBBBBB B
 BBBBBBBBBBBBB BBBBBBBB BBBBBBBBBBBBBBB BBBBBBBB B
 BBBBBBBBBBBBB BBBBBBBB BBBBBBBBBBBBBBB BBBBBBBB B
               BBBBBBBB                          B
