               BBBBBPBBBBB        BBBBB          B
 BBBBBBBBBBBBB BBBBB BBBBB BBBBBB BBBBB BBBBBBBB B
 BBBBBBBBBBBBB BBBBB BBBBB BBBBBB BBBBB BBBBBBBB B
 BBBBBBBBBBBBB BBBBB BBBBBLBBBBBB BBBBB BBBBBBBB B
         BBBBBLBBBBB BBBBBBBBBBBB       BBBBBBBB B
 BBBBBBB BBBBBBBBBBB BBBBBBBBBBBB BBBBB BBBBBBBB B
 BBBBBBB BBBBBBBBBBB BBBBBBBBBBBB BBBBB BBBBBBBB B
 BBBBBBB BBBBBBBBBBB BBBB         BBBBB BBBBBBBB B
 BBBBBBB             BBBB BBBBBBBBBBBBB BBBBBBBB B
BBBBBBBBBBBBBBBBBBBB BBBB BBBBBBBBBBBBB          B
BBBBBBBBBBBBBBBBBBBB BBBB BBBBBBBBBBBBB BBBBBBBBBB
BBBBBBBBBBBBBBBBBBBB BBBB BBBBBBBBBBBBB BBBBBBBBBB
               BBBBB              BBBBB BBBBBBBBBB
BBBBBBBBBBBBBB BBBBBBBBBBBBBBBBBB BBBBB BBBBBBBBLB
BBBBBBBBBBBBBB BBBBBBBBBBBBBBBBBB BBBBB BBBBBBBB B
BBBBBBBBBBBBBB BBBBBBBBBBBBBBBBBB BBBBB BBBBBBBB B
SBBBBBBBBBBBBB          BBBBBBBBBBBBBBB BBBBBBBB B
 BBBBBBBBBBBBB BBBBBBBB BBBBBBBBBBBBBBB BBBBBBBB B
 BBBBBBBBBBBBB BBBBBBBB BBBBBBBBBBBBBBB BBBBBBBB B
               BBBBBBBB                          B
