               BBBBB BBBBB        BBBBB          B
 BBBBBBBBBBBBB BBBBB BBBBB BBBBBB BBBBB BBBBBBBB B
 BBBBBBBBBBBBB BBBBB BBBBB BBBBBB BBBBB BBBBBBBB B
 BBBBBBBBBBBBB BBBBB BBBBBPBBBBBB BBBBB BBBBBBBB B
         BBBBBLBBBBB BBBBBBBBBBBB       BBBBBBBB B
 BBBBBBB BBBBBBBBBBB BBBBBBBBBBBB BBBBB BBBBBBBB B
 BBBBBBB BBBBBBBBBBB BBBBBBBBBBBB BBBBB BBBBBBBB B
 BBBBBBB BBBBBBBBBBB BBBB         BBBBB BBBBBBBB B
 BBBBBBB             BBBB BBBBBBBBBBBBB BBBBBBBB B
 BBBBBBBBBBBBBBBBBBB BBBB BBBBBBBBBBBBB          B
 BBBBBBBBBBBBBBBBBBB BBBB BBBBBBBBBBBBB BBBBBBBBBB
 BBBBBBBBBBBBBBBBBBB BBBB BBBBBBBBBBBBB BBBBBBBBBB
               BBBBB              BBBBB BBBBBBBBBB
 BBBBBBBBBBBBB BBBBBBBBBBBBBBBBBB BBBBB BBBBBBSBBB
 BBBBBBBBBBBBB BBBBBBBBBBBBBBBBBB BBBBB BBBBBB BBB
 BBBBBBBBBBBBB BBBBBBBBBBBBBBBBBB BBBBB BBBBBB BBB
 BBBBBBBBBBBBB          BBBBBBBBBBBBBBB BBBBBB BBB
 BBBBBBBBBBBBB BBBBBBBB BBBBBBBBBBBBBBB BBBBBB BBB
               BBBBBBBB BBBBBBBBBBBBBBB BBBBBB BBB
BBBBBBBBBBBBBBBBBBBBBBB                        BBB
