PWWWWWW       WWWWW        WWW
 WWWWWWWWWWWW WWWWW WWWWWW WWW
 WWWWWWWWWWWW WWWWW WWWWWW WWW
 WWWWWWWWWWWW WWWWW WWWWWW WWW
 WWWWWWWWWWWW       WWWWWW WWW
 WWWWWWWWWWWW WWWWW WWWWWW WWW
 WWWWWWWWWWWW WWWWW WWWWWW WWW
 WWWW         WWWWW WWWWWW WWW
 WWWW WWWWWWWWWWWWW WWWWWW WWW
 WWWW WWWWWWWWWWWWW        WWW
 WWWW WWWWWWWWWWWWW WWWWWWWWWW
 WWWW WWWWWWWWWWWWW WWWWWWWWWW
              WWWWW WWWWWWWWWW
WWWWWWWWWWWWWWWWWWW WWWWWWWWWW
WWW     LWWWWWWWWWW WWWWWWWWWW
WWW WWWWWWWWWWWWWWW WWWWWWWWWW
WWW WWWWWWWWWWWWWWW WWWWWWWWWW
WWW                 WWWWWWWWWW
WWW WWWWWWWWWWWWWWWWWWWWWWWWWW
WWWWWWWWWWWWWWWWWWWWWWWWWWWWWW
