               BBBBBSBBBBB        BBBBB          B
 BBBBBBBBBBBBB BBBBB BBBBB BBBBBB BBBBB BBBBBBBB B
 BBBBBBBBBBBBB BBBBB BBBBB BBBBBB BBBBB BBBBBBBB B
 BBBBBBBBBBBBB BBBBB BBBBBLBBBBBB BBBBB BBBBBBBB B
         BBBBBLBBBBB BBBBBBBBBBBB       BBBBBBBB B
BBBBBBBB BBBBBBBBBBB BBBBBBBBBBBB BBBBB BBBBBBBB B
BBBBBBBB BBBBBBBBBBB BBBBBBBBBBBB BBBBB BBBBBBBB B
BBBBBBBB BBBBBBBBBBB BBBB         BBBBB BBBBBBBB B
BBBBBBBB             BBBB BBBBBBBBBBBBB BBBBBBBB B
 BBBBBBBBBBBBBBBBBBB BBBB BBBBBBBBBBBBB          B
 BBBBBBBBBBBBBBBBBBB BBBB BBBBBBBBBBBBB BBBBBBBBBB
 BBBBBBBBBBBBBBBBBBB BBBB BBBBBBBBBBBBB BBBBBBBBBB
               BBBBB              BBBBB BBBBBBBBBB
BBBBBBBBBBBBBB BBBBBBBBBBBBBBBBBB BBBBB BBBBBBBBLB
BBBBBBBBBBBBBB BBBBBBBBBBBBBBBBBB BBBBB BBBBBBBB B
BBBBBBBBBBBBBB BBBBBBBBBBBBBBBBBB BBBBB BBBBBBBB B
PBBBBBBBBBBBBB          BBBBBBBBBBBBBBB BBBBBBBB B
 BBBBBBBBBBBBB BBBBBBBB BBBBBBBBBBBBBBB BBBBBBBB B
 BBBBBBBBBBBBB BBBBBBBB BBBBBBBBBBBBBBB BBBBBBBB B
               BBBBBBBB                          B
