               BBBBBSBBBBB        BBBBB          B
 BBBBBBBBBBBBB BBBBB BBBBB BBBBBB BBBBB BBBBBBBB B
 BBBBBBBBBBBBB BBBBB BBBBB BBBBBB BBBBB BBBBBBBB B
 BBBBBBBBBBBBB BBBBB BBBBBLBBBBBB BBBBB BBBBBBBB B
         BBBBBLBBBBB BBBBBBBBBBBB       BBBBBBBB B
 BBBBBBB BBBBBBBBBBB BBBBBBBBBBBB BBBBB BBBBBBBB B
 BBBBBBB BBBBBBBBBBB BBBBBBBBBBBB BBBBB BBBBBBBB B
 BBBBBBB BBBBBBBBBBB BBBB         BBBBB BBBBBBBB B
 BBBBBBB             BBBB BBBBBBBBBBBBB BBBBBBBB B
 BBBBBBBBBBBBBBBBBBBBBBBB BBBBBBBBBBBBB          B
 BBBBBBBBBBBBBBBBBBBBBBBB BBBBBBBBBBBBB BBBBBBBBBB
 BBBBBBBBBBBBBBBBBBBBBBBB BBBBBBBBBBBBB BBBBBBBBBB
               BBBBBBBBBB         BBBBB BBBBBBBBBB
BBBBBBBBBBBBBB BBBBBBBBBBBBBBBBBB BBBBB BBBBBBBBLB
BBBBBBBBBBBBBB BBBBBBBBBBBBBBBBBB BBBBB BBBBBBBB B
BBBBBBBBBBBBBB BBBBBBBBBBBBBBBBBBPBBBBB BBBBBBBB B
LBBBBBBBBBBBBB          BBBBBBBBBBBBBBB BBBBBBBB B
 BBBBBBBBBBBBB BBBBBBBB BBBBBBBBBBBBBBB BBBBBBBB B
 BBBBBBBBBBBBB BBBBBBBB BBBBBBBBBBBBBBB BBBBBBBB B
　　　　　　　 BBBBBBBB                          B
