               BBBBB BBBBB        BBBBB         LB
 BBBBBBBBBBBBB BBBBB BBBBB BBBBBB BBBBB BBBBBBBBBB
 BBBBBBBBBBBBB BBBBB BBBBB BBBBBB BBBBB BBBBBBBBBB
 BBBBBBBBBBBBB BBBBB BBBBBPBBBBBB BBBBB BBBBBBBBBB
         BBBBBLBBBBB BBBBBBBBBBBB       BBBBBBBBBB
 BBBBBBB BBBBBBBBBBB BBBBBBBBBBBB BBBBB BBBBBBBB B
 BBBBBBB BBBBBBBBBBB BBBBBBBBBBBB BBBBB BBBBBBBB B
 BBBBBBB BBBBBBBBBBB BBBB         BBBBB BBBBBBBB B
 BBBBBBB             BBBB BBBBBBBBBBBBB BBBBBBBB B
 BBBBBBBBBBBBBBBBBBB BBBB BBBBBBBBBBBBB          B
 BBBBBBBBBBBBBBBBBBB BBBB BBBBBBBBBBBBB BBBBBBBBBB
 BBBBBBBBBBBBBBBBBBB BBBB BBBBBBBBBBBBB BBBBBBBBBB
               BBBBB              BBBBB BBBBBBBBBB
 BBBBBBBBBBBBB BBBBBBBBBBBBBBBBBB BBBBB BBBBBBBBSB
 BBBBBBBBBBBBB BBBBBBBBBBBBBBBBBB BBBBB BBBBBBBB B
 BBBBBBBBBBBBB BBBBBBBBBBBBBBBBBB BBBBB BBBBBBBB B
 BBBBBBBBBBBBB          BBBBBBBBBBBBBBB BBBBBBBB B
 BBBBBBBBBBBBB BBBBBBBB BBBBBBBBBBBBBBB BBBBBBBB B
 BBBBBBBBBBBBB BBBBBBBB BBBBBBBBBBBBBBB BBBBBBBB B
LBBBBBB        BBBBBBBB                          B
